...########
..#......##
.##.####..#
##........#
#...@.....#
#......##.#
.##.......#
.##...#.##
.#.....###
.#.....##
..######..