###########
#.........#
#.#.#...#.#
#.#.##.##.#
#.#.#...#.#
#.#.#.@.#.#
#.#.#...#.#
#.#.##.##.#
#.#.#...#.#
#.........#
###########