###########
#.#########
#.#.#...#.#
#.#.#####.#
#.#.#...#.#
#.....@...#
#.#.#...#.#
#.#.#####.#
#.#.#...#.#
#.#########
###########