###########
#@........#
#########.#
#.........#
#.#########
#.#...#...#
#.#.#.#.#.#
#.#.#.#.#.#
#.#.#.#.#.#
#...#...#.#
#########.#