#####.#####
#.........#
#.........#
#.........#
#.........#
.....@.....
#.........#
#.........#
#.........#
#.........#
#####.#####